96
11
0 0 1 2 1 2 3 4 5 6 7 7 7 7 7 7 7 7 7 7 7 7 7 7 7 7 7 7 7 7 7 7 7 7 7 7 7 7 7 7 7 7 7 7 7 7 7 7 7 7 7 7 7 7 7 7 7 7 7 7 7 7 7 7 7 7 7 7 7 7 7 7 7 7 7 7 7 7 7 7 7 7 7 7 7 7 7 7 7 7 7 7 8 9 1 2
0 0 10 11 12 13 3 4 7 7 7 7 7 7 7 7 7 7 7 7 7 7 7 7 7 7 7 7 7 7 7 7 7 7 7 7 7 7 7 7 7 7 7 7 7 7 7 7 7 7 7 7 7 7 7 7 7 7 7 7 7 7 7 7 7 7 7 7 7 7 7 7 7 7 7 7 7 7 7 7 7 7 7 7 7 7 8 14 15 14 15 14 16 17 12 13
0 0 18 19 20 21 3 4 7 7 7 7 7 7 7 7 7 7 7 7 7 7 7 7 7 7 7 7 7 7 7 7 7 7 7 7 7 7 7 7 7 7 7 7 7 7 7 7 7 7 7 7 7 7 7 7 7 7 7 7 7 7 7 7 7 7 7 7 7 7 7 7 7 7 7 7 7 7 7 7 7 7 7 7 7 7 8 9 15 15 15 15 1 2 20 21
0 0 22 23 16 17 24 25 7 7 7 7 7 7 7 7 7 7 7 7 7 7 7 7 7 7 7 7 7 7 7 7 7 7 7 7 7 7 7 7 7 7 8 14 16 17 16 17 15 14 15 26 7 7 7 7 7 7 7 7 7 7 7 7 7 7 7 7 7 7 7 7 7 7 7 7 7 7 7 7 7 7 7 7 7 7 27 28 15 15 15 15 16 17 16 17
0 0 29 30 1 2 5 6 7 7 7 7 7 7 7 7 7 7 7 7 7 7 7 7 7 7 7 7 7 7 7 7 7 7 7 7 7 7 7 7 7 7 8 9 1 2 1 2 15 15 15 26 7 7 7 7 7 7 7 7 7 7 7 7 7 7 7 7 7 7 7 7 7 7 7 7 7 7 7 7 7 7 7 7 7 7 31 32 15 33 15 33 1 2 1 2
0 0 34 34 34 34 34 34 34 34 34 34 34 34 34 34 34 34 34 34 35 7 34 34 35 7 34 34 35 7 34 34 34 34 34 34 35 7 34 34 35 7 34 34 34 34 34 34 34 34 34 34 34 34 35 7 34 34 34 34 35 7 34 34 34 34 35 7 34 34 35 7 34 34 35 7 34 34 34 34 34 34 34 34 34 34 36 37 15 15 15 15 27 28 16 17
0 0 38 38 38 38 38 38 38 38 38 38 38 38 38 38 38 38 38 38 39 40 38 38 39 40 38 38 39 40 38 38 38 38 38 38 39 40 38 38 39 40 38 38 38 38 38 38 38 38 38 38 38 38 39 40 38 38 38 38 39 40 38 38 38 38 39 40 38 38 39 40 38 38 39 40 38 38 38 38 38 38 38 38 38 38 41 36 15 33 15 33 31 32 1 2
0 0 16 17 16 17 16 17 16 17 16 17 42 43 44 45 44 45 44 45 44 45 46 47 46 47 46 47 44 45 44 45 44 45 46 47 44 45 44 45 44 45 48 49 48 49 48 49 48 49 48 49 46 47 44 45 44 45 46 47 44 45 44 45 44 45 46 47 44 45 44 45 44 45 44 45 44 45 44 45 46 47 50 51 52 53 16 17 36 37 15 15 54 55 16 17
0 0 1 2 1 2 1 2 1 2 1 2 56 57 58 58 58 58 58 58 58 58 6 59 6 59 6 59 58 58 58 58 58 58 6 59 58 58 58 58 58 58 60 60 60 60 60 60 60 60 60 60 6 59 58 58 58 58 6 59 58 58 58 58 58 58 6 59 58 58 58 58 58 58 58 58 58 58 58 58 6 59 61 62 63 64 1 2 41 36 15 33 54 55 1 2
0 0 16 17 57 65 7 61 27 28 16 17 57 65 66 7 66 7 8 14 7 7 35 7 15 26 66 7 66 7 66 7 66 7 66 7 66 7 8 14 15 26 27 28 16 17 12 13 12 13 3 4 66 7 66 7 66 7 66 7 66 7 66 7 66 7 66 7 66 7 66 7 66 7 66 7 66 7 66 7 66 7 7 61 34 34 34 34 34 34 34 34 34 34 34 34
0 0 1 2 67 68 69 70 31 32 1 2 67 68 68 71 68 71 8 9 35 72 39 40 15 26 68 71 68 71 68 71 68 71 68 71 68 71 8 9 15 26 31 32 1 2 20 21 20 21 3 4 68 71 68 71 68 71 68 71 68 71 68 71 68 71 68 71 68 71 68 71 68 71 68 71 68 71 68 71 68 71 69 70 38 38 38 38 38 38 38 38 38 38 38 38