48
11
0 0 1 2 3 4 5 6 3 4 0 0 7 8 9 10 11 12 13 14 15 11 16 17 18 19 20 21 16 17 0 0 22 23 3 4 3 4 24 25 26 27 5 6 3 4 1 28
0 0 1 2 29 5 3 3 30 31 0 0 32 8 33 34 35 3 11 15 36 37 38 39 40 41 42 43 1 44 0 0 1 44 45 46 3 3 30 31 29 5 3 3 30 31 47 48
0 0 1 2 49 6 3 4 26 27 0 0 11 12 20 21 50 51 15 11 52 53 54 55 11 19 11 11 1 44 0 0 1 44 56 57 3 4 26 27 5 6 3 4 26 27 58 59
0 0 60 60 61 60 60 60 62 63 11 11 36 37 64 14 60 60 65 66 33 34 9 10 67 68 64 14 1 44 0 0 1 44 30 31 29 5 60 60 3 3 3 3 3 3 69 70
0 0 22 23 22 23 22 23 71 62 11 11 52 53 64 14 22 23 16 17 20 21 52 72 18 19 64 14 1 44 0 0 1 44 26 27 5 6 3 3 3 4 3 4 3 4 69 70
0 0 1 2 3 3 45 73 30 31 62 63 30 31 64 14 1 44 38 39 40 41 42 43 74 72 64 14 1 44 0 0 1 44 29 5 3 3 3 3 3 3 3 3 60 60 0 0
0 0 1 2 3 4 24 25 26 27 71 62 26 27 64 14 1 44 54 55 11 19 11 11 75 72 13 14 1 44 0 0 1 44 5 6 3 4 3 4 3 4 3 4 22 23 0 0
0 0 1 2 3 3 76 77 3 3 45 73 62 63 64 14 1 44 9 10 60 60 33 34 78 79 0 0 0 0 0 0 0 0 0 0 0 0 0 0 60 60 3 3 1 44 0 0
0 0 1 2 3 4 80 81 3 4 24 25 71 62 13 14 1 44 52 72 22 23 20 21 82 83 0 0 0 0 0 0 0 0 0 0 0 0 0 0 22 23 3 4 1 44 0 0
0 0 1 2 30 31 3 3 3 3 60 60 30 31 0 0 0 0 64 14 78 79 36 37 78 79 64 14 60 60 0 0 0 0 0 0 0 0 0 0 1 44 3 3 1 44 0 0
0 0 1 2 26 27 3 4 3 4 3 3 26 27 0 0 0 0 64 14 82 83 52 53 82 83 64 14 22 23 0 0 0 0 0 0 0 0 0 0 1 44 3 4 1 44 0 0