17
11
0 1 2 1 2 3 4 5 5 5 5 5 5 5 5 6 7
8 9 10 11 12 11 12 4 13 5 5 5 5 5 5 6 7
14 15 0 1 2 1 2 3 4 5 5 5 5 5 5 6 7
5 16 15 9 10 11 12 17 18 4 13 5 5 5 5 6 7
5 5 16 15 0 1 2 19 20 3 4 5 5 5 5 6 7
5 5 5 21 8 16 15 22 9 9 10 23 23 23 23 23 23
5 5 5 24 14 5 16 25 15 15 0 26 27 26 27 26 27
5 5 5 5 5 5 5 21 8 15 15 9 10 11 12 11 12
5 5 5 5 5 5 5 24 14 15 15 15 0 1 2 1 2
5 5 5 5 5 5 5 5 5 21 8 16 15 9 10 11 12
28 29 30 29 30 28 28 28 28 24 14 5 16 15 0 1 2