46
11
0 1 2 3 4 5 2 3 4 5 2 3 4 6 0 1 7 2 2 8 9 10 0 11 12 13 2 8 9 10 0 1 7 14 15 16 17 17 17 17 17 18 19 20 15 21
0 1 2 22 23 24 2 22 23 24 2 22 23 25 0 1 7 26 0 1 2 26 0 1 2 26 0 1 2 26 0 1 7 27 28 29 17 17 17 17 30 31 32 33 28 34
0 1 2 22 23 24 2 22 23 24 2 22 23 25 0 1 7 26 0 35 4 6 0 35 4 6 0 35 4 6 0 1 7 14 36 37 17 17 17 17 38 39 40 41 36 42
0 1 2 22 23 24 2 22 23 24 2 22 23 25 0 1 7 26 0 43 23 25 0 43 23 25 0 43 23 25 0 11 44 45 46 47 17 17 48 49 50 51 52 53 13 54
0 1 2 22 23 24 2 22 23 24 2 22 23 25 0 1 7 26 0 43 23 25 0 43 23 25 0 43 23 25 0 55 56 57 58 59 17 17 60 61 62 63 64 65 12 66
0 1 2 22 23 24 2 22 23 24 2 22 23 25 0 1 2 26 0 43 23 25 0 43 23 25 0 43 23 25 0 1 2 57 17 17 67 68 69 70 17 38 52 71 72 73
0 1 2 22 23 24 2 22 23 24 2 22 23 25 0 1 2 26 0 43 23 25 0 43 23 25 0 43 23 25 0 1 2 57 17 17 17 74 75 76 17 38 77 78 79 80
0 1 2 2 2 2 81 82 83 84 85 2 2 26 0 1 2 26 0 43 23 25 0 43 23 25 0 1 7 7 7 7 7 86 87 88 17 17 17 17 17 38 89 90 44 91
0 1 2 2 2 92 93 94 95 96 97 2 2 26 0 1 2 26 0 43 23 25 0 43 23 25 0 11 98 99 98 99 98 100 101 102 17 17 17 17 17 38 103 104 56 54
7 7 7 7 7 7 7 7 7 7 7 7 7 7 7 7 7 7 7 7 7 7 7 7 7 7 7 7 7 7 105 106 107 108 44 109 87 88 17 17 17 62 107 2 110 111
7 7 7 7 7 7 7 7 7 7 7 7 7 7 7 112 98 99 98 99 98 99 98 99 98 99 98 99 98 113 114 17 62 115 56 116 101 102 17 17 17 17 62 117 118 119