48
11
0 0 1 2 3 4 0 0 0 0 5 6 7 8 9 6 10 11 12 13 7 8 5 14 15 16 7 8 17 18 19 20 21 22 3 4 23 24 3 4 23 24 3 4 3 4 0 0
3 25 1 2 3 3 26 27 28 28 0 0 29 30 31 32 33 11 34 35 36 37 38 39 38 35 17 18 17 18 40 3 1 41 40 3 40 3 40 3 40 3 3 3 42 43 0 0
3 25 1 2 3 4 44 45 3 3 0 0 15 16 7 8 12 13 9 6 46 47 5 14 5 6 17 18 17 18 48 49 1 41 48 49 48 49 48 49 48 49 3 4 23 24 0 0
3 25 1 2 3 3 42 43 3 3 0 0 12 50 36 37 36 37 51 52 53 54 55 56 57 58 17 18 0 0 0 0 28 28 28 28 28 28 28 28 28 28 59 60 40 3 0 0
3 25 1 2 3 4 23 24 3 4 0 0 10 11 46 47 46 47 61 62 34 35 12 14 12 12 17 18 0 0 0 0 21 22 3 3 3 3 3 3 3 3 63 59 48 49 0 0
0 0 28 28 59 60 26 27 3 3 0 0 33 11 64 65 40 3 40 3 9 6 38 39 34 35 17 18 38 35 0 0 1 41 3 3 3 3 26 27 3 3 66 67 28 28 0 0
0 0 21 22 63 59 44 45 3 4 0 0 12 13 68 65 48 49 48 49 46 65 5 14 9 6 69 18 5 6 0 0 1 41 3 4 3 4 44 45 3 4 67 70 3 3 0 0
0 0 1 2 3 3 59 60 26 27 0 0 38 35 64 65 0 0 0 0 59 60 53 54 55 56 57 58 64 65 0 0 1 41 40 3 40 3 3 3 66 67 3 3 40 3 0 0
0 0 1 2 3 4 63 59 44 45 0 0 5 6 68 65 0 0 0 0 63 59 34 35 12 14 12 12 68 65 0 0 1 41 48 49 48 49 3 4 67 70 3 4 48 49 0 0
0 0 1 2 3 3 66 67 0 0 0 0 12 50 34 35 36 37 17 18 12 71 28 28 38 39 53 54 57 58 0 0 0 0 0 0 0 0 0 0 28 28 66 67 28 28 0 0
0 0 1 2 3 4 67 70 0 0 0 0 10 11 9 6 46 47 17 18 72 12 21 22 5 14 34 35 12 12 0 0 0 0 0 0 0 0 0 0 3 3 67 70 3 3 0 0